############### ##############
#     #      ## #      #     #
# ### # #### ## # #### # ### #
#                            #
# ### # ### ###### ### # ### #
#     #     ######     #     #
##### #### ######## #### #####
    #        ####        #    
    # ###### #### ###### #    
    #                    #    
##### #### #### ### #### #####
      ###  #   G  #  ###      
##### #### ######## #### #####
    #                    #    
    # ###### #### ###### #    
    #        ####        #    
##### #### ######## #### #####
#     #     ######     #     #
#                            #
# ### # #### ## # #### # ### #
#     #      ##P#      #     #
################################################