############### A#############
#     #      ## #      #     #
# ### # #### ## # #### # ### #
#                            #
# ### # ### ###### ### # ### #
#     #     ######     #     #
##### #### ######## #### #####
    #        ####        #    
    # ###### #### ###### #    
    #       ++           #    
##### #### #### ### #### #####
      ###  #   G  #  ###      
##### #### ######## #### #####
    #                    #    
    # ###### #### ###### #    
    #        ####        #    
##### #### ######## #### #####
#     #     ######     #     #
#                 RR         #
# ### # #### ## # #### # ### #
#     #      ##P#      #     #
##############################