############################
#            ##            #
# #### ##### ## ##### #### #
# #### ##### ## ##### #### #
#                          #
# #### ## ######## ## #### #
#      ##    ##    ##      #
###### ##### ## ##### ######
     # ##          ## #     
     # ## ### ### ##  #     
###### ## #      # ## ######
          #  P   #          
###### ## #      # ## ######
     # ## ######## ## #     
     # ##          ## #     
###### ## ######## ## ######
#      ##            #      
# #### ##### ## ##### #### #
#   ##                ##   #
### ## ## ######## ## ## ###
#      ##    ##    ##      #
# ########## ## ########## #
#            G             #
############################